     ________________________________
7    |   ____________    ________   |
6    |______|       |       | *  _E_|
5    |      |   |___|___|   | * |   |
4    |  |_______|       |   |_*__ * |
3    |___   |____   |_______|   | * |
2    |  |___________|    ____   | * |
1    | E ___________| *   * |___| * |
0    |_*__*___*___*___*_|_*___*___*_|

      0   1   2   3   4   5   6   7   