     ____________________
4    |   ________    ___|
3    |  | *   * |___| E |
2    |   _E_|_*__ * | * |
1    |_______   |_*___*_|
0    |__________________|

      0   1   2   3   4   