     ____________________
4    |  |    ____   |   |
3    |  |   |   |   | E |
2    |  |_E__ * |   | * |
1    |   ___| * |___| * |
0    |________*___*___*_|

      0   1   2   3   4   
