     ____________________
4    |  |    ____   |   |
3    |  |   |   |   |   |
2    |  |____   |   |   |
1    |   ___|   |___|   |
0    |__________________|

      0   1   2   3   4   
